ND-CTL-NAME = Ring Controller
ND-CTL-ICON = GenericCtl
ST-CTL-ST-NAME = NodeServer Status
ST-CTL-GV0-NAME = Test result
CMD-CTL-DISCOVER-NAME = Discover devices
CMD-CTL-QUERYALL-NAME = Query All
CMD-CTL-TEST-NAME = Test Ring

ONLINE-0 = Offline
ONLINE-1 = Online

TESTRESULT-0 = Not tested
TESTRESULT-1 = Testing...
TESTRESULT-2 = Success
TESTRESULT-3 = Timeout
TESTRESULT-4 = Failure
TESTRESULT-5 = Ring Auth. Failure

ND-DOORBELL-NAME = Doorbell
ND-DOORBELL-ICON = DoorLock
ST-DB-ST-NAME = Status
ST-DB-BATLVL-NAME = Battery life
ST-DB-GV0-NAME = Battery life 2
ST-DB-GV1-NAME = Battery mV
CMD-DB-DON-NAME = Ding

ND-DOORBELLMOTION-NAME = Doorbell Motion
ND-DOORBELLMOTION-ICON = MotionSensor
CMD-DBM-DON-NAME = Motion
CMD-DBM-DOF-NAME = Motion timeout

ND-CAMERA-NAME = Camera Motion
ND-CAMERA-ICON = MotionSensor
ST-CAM-ST-NAME = Status
ST-CAM-BATLVL-NAME = Battery life
ST-CAM-GV0-NAME = Battery life 2
ST-CAM-GV1-NAME = Battery mV
CMD-CAM-DON-NAME = Motion
CMD-CAM-DOF-NAME = Motion timeout
CMD-CAM-QUERY-NAME = Query

ND-LIGHT-NAME = Floodlight
ND-LIGHT-ICON = Lamp
CMD-L-DON-NAME = Turn on
CMD-L-DOF-NAME = Turn off
